15,7,7,15,15,7,7,7,7,3
11,0,0,14,11,0,0,0,0,0
11,0,0,14,11,0,0,0,0,0
11,0,0,14,11,0,0,12,13,13
11,0,0,2,2,0,0,14,15,7
11,0,0,0,0,0,0,14,11,0
11,0,0,0,0,0,0,14,11,0
11,0,0,4,13,13,13,15,3,0
11,0,0,4,7,7,7,15,9,0
11,0,0,0,0,0,0,14,11,0
